11111111111111111
11000000000000001
1000000000000011111111
100000000000011
111111111111111