000001111111111111111111
11111000000000000000000011111
100011100000000000000000000001
100000000000000000000000000001
100000000010000000000000000001
100000000000000000100000000001
100000000100000000100000000001
100000000000000001000000000001
100000000000000001000000000001
110111111111111111111111111111
001111111100000000000000000000000000