  11111111111111
110000000000011
1000010000000001
100000000000011
11111111111111