NO   ./pics/eagle.png
SE   ./pics/eagle.png
WE   ./pics/eagle.png
EA   ./pics/eagle.png

F 255,0,0
C 255,0,0
1111111111111111111111111111
1000000000000000000000000001
1000000000000001000000000001
100000000000000000000N000001
1000000000000000000000000001
1111111111111111111111111111