NO   ./pics/redbrick.png
SE   ./pics/bluestone.png
WE   ./pics/colorstone.png
EA   ./pics/wood.png

F 255,0,0
C 255,0,0
1111111111111111111111111111
1000000000000000000000000001
1000000000000001000000000001
100000000000000000000E000001
1000000000000000000000000001
1111111111111111111111111111