NO   mandatory/pics/lufy.png
SE   mandatory/pics/zoro.png
WE   mandatory/pics/sa bo.png
EA   mandatory/pics/wood.png
F 255,229,255
C 51,255,255



        1111111111111111111111111
        1000000000110000000000001
        1011000001110000000000001
        1001000000000000000000001
111111111011000001110000000000001
100000001011000001110111111111111
11110111111111011100000010001
11110111111101011101010010001
11000000110111011100000000001
10000000000000001100000N00001
10000000000000001100000000001
11111111111111111111111111111