NO   mandatory/pics/rsz_1s8amfjbu8mk71.png
SE   mandatory/pics/rsz_itashi.png
WE   mandatory/pics/rsz_ezgifcom-gif-maker.png
EA   mandatory/pics/rsz_1rsz_naruto.png
F 255,255,255
C 51,255,255


        1111111111111111111111111
        1000000000110000000000001
        1011000001110000000000001
        1001000000000000000000001
111111111011000001110000000000001
100000001011000001110111111111111
111101111111110111000000111111111
111101111111010111010010010001
110000001101110111000000000001
100000000000W0```001100000000001
1000000000000001100000000001
11111111111111111111111111111












