NO   mandatory/pics/redbrick.png
SE   mandatory/pics/bluestone.png
WE   mandatory/pics/colorstone.png
EA   mandatory/pics/wood.png

F 255,0,0
C 255,0,0
1111111111111111111111111111111111111111111111
1000000000000000000000000000000000000000000001
1000000000000000000000000000000000000000000001
1000000000000000000000000000000000000000000001
1000000000000000000000000000000000000000000001
1000000000000000000000000000000000000000000001
1000000000000000000000000000000000000000000001
1000000000000000000000000000000000000000000001
1000000000000000000000000000000000000000000001
1000000000000000000000000000000000000000000001
100000000000000000000E000000000000000000000001
1000000000000000000000000000000000000000000001
1000000000000000000000000000000000000000000001
1000000000000000000000000000000000000000000001
1000000000000000000000000000000000000000000001
1000000000000000000000000000000000000000000001
1000000000000000000000000000000000000000000001
1000000000000000000000000000000000000000000001
1000000000000000000000000000000000000000000001
1000000000000000000000000000000000000000000001
1111111111111111111111111111111111111111111111