NO   mandatory/pics/lufy.png
SE   mandatory/pics/zoro.png
WE   mandatory/pics/sabo.png
EA   mandatory/pics/wood.png

F 204,229,255
C 51,255,255
        1111111111111111111111111
        1000000000110000000000001
        1011000001110000000000001
        1001000000000000000000001
111111111011000001110000000000001
100000001011000001110111111111111
11110111111111011100000010001
11110111111111011101010010001
11000000110101011100000000001
10000000000000001100000000001
10000000000000001100000000001
10000000000000001100000000001
10000000000000001100000000001
10000000000000001100000000001
10000000000000001100000000001
10000000000000001100000000001
10000000000000001100000000001
10000000010110001100000000001
100000N0001100001100000000001
10000000000100001100000000001
10000000000000001100000000001
10000000000000001100000000001
10000000000000001100000000001
10000000000000001100000000001
10000000000000001100000000001
10000000000000001100000000001
10000000000000001100000000001
10000000000000001100000000001
10000000000000001100000000001
10000000000000001100000000001
10000000000000001100000000001
10000000000000001100000000001
10000000000000001100000000001
10000000000000001100000000001
10000000000000001100000000001
10000000000000001100000000001
10000000000000001100000000001
10000000000000001100000000001
10000000000000001100000000001
10000000000000001100000000001
10000000000000001100000000001
10000000000000001100000000001
10000000000000001100000000001
10000000000000001100000000001
10000000000000001100000000001
10000000000000001100000000001
10000000000000001100000000001
10000000000000001100000000001
10000000000000001100000000001
10000000000000001100000000001
10000000000000001100000000001
10000000000000001100000000001
10000000000000001101010000001
11000001110101011111011000001
11110111111101011101111010001
11111111111111111111111111111